XXXXXXXXXXX'XXXXXXXX
X'X'''''''X'X'X''''X
X'X''XXXX'X'X'XXXXLX
X'X''''X''X'X''''X'X
X'XX'XXXXXX'XXX''''X
X'XX'X''''''X'XXXX'X
X''''XXXXXX'X'X''X'X
XXXX'X''''''X'X'XX'X
X''X'X'XXXXXX'''X''X
X'XX'X''''''X'XXX''X
X'X''XXX''X'C''''''X
X''''''X'XXXXXXX'''X
XX''XXXX'X'''''''''X
XX'''''''X'XXXXXX''X
X'''X''X'X'X'X'''''X
XXXXX''X'X'X'XXXXX'X
X'X'X''X'''X'X'XX''X
X''''''X'''X'''''''X
XXXXXXXXXXXXXXXXXXXX

