XXXXXXXXXXX'XXXXXXXX
X'X'''''''X'X'X''''X
X'X'''XXXXX'X'XX'''X
X'X''''X''''X''''''X
X''''XXXX'''XXX''''X
X''''X''''''X'XXXX'X
X'L''XXX''''X'X''X'X
XXXX'X''''''X'X'XX'X
X''X'X'XXXXXX'''X''X
X'XX'X''''''X'''X''X
X''''XX'''X'C''''''X
X'''''CX'XXX'''''''X
XX'''XXX'X'''''''''X
XX'''''''X'XXXX''''X
X''''''X'X'X'X'''''X
XXX''''X'''X'XXX'''X
X'X''''X'''X'X'X'''X
X''''''X'''X'''''''X
XXXXXXXXXXXXXXXXXXXX

