XXXXXXXXXXX'XXXXXXXX
X'X'''''C'X'X'X''''X
X'X''XXXX'X'X'XXXX'X
X'X''''X''X'X''C'X'X
X'XX'XXXXXX'XXX''''X
X'XX'X''''''X'XXXX'X
X''''XXXXXX'X'X''X'X
XXXX'XL'''''X'X'XX'X
X''X'X'XXXXXX'''X''X
X'XX'X''''''X'XXX''X
X'X''XXX''X''''''L'X
X''''''X'XXXXXXX'''X
XX'CXXXX'X'''''''''X
XX'''''''X'XXXXXX''X
X'''X'LX'X'X'X'''C'X
XXXXX''X'X'X'XXXXX'X
X'X'X''X'''X'X'XX''X
X''''''X'''X'''''''X
XXXXXXXXXXXXXXXXXXXX

